NO ./textures/north.xpm
SO ./textures/south.xpm
WE ./textures/west.xpm
EA ./textures/east.xpm

F 109, 89, 122
C 229, 107, 111

111111111111
100000000001
100000000001
10000S000001
100000000001
100000000001
100000000001
100000000001
111111111111
