   WE                            ./textures/west.xpm 
NO      ./textures/north.xpm



SO ./textures/south.xpm

F   109, 89, 122

EA ./textures/east.xpm



C 229, 107, 111

11111111111111111111111111
11000000000000000000000011
11000000000000000000000011
1100000000N000000000000011
11000000000000000000000011
11000000000000000000000011
11000000000000000000000011
11000001111100001010100011
11000001000100000000000011
11000001000100001000100011
11000001000100000000000011
11000001111000010101000011
11000000000000000000000011
11000000000000000000000011
11000000000000000000000011
11000000000000000000000011
11000000000000000000000011
11000000000000000000000011
11000000000000000000000011
11111111110000000000000011
11001000010000000000000011
11000001010000000000000011
11001000010000000000000011
11001111110000000000000011
11000000000000000000000011
11000000000000000000000011
11111111111111111111111111
