	EA ./textures/polished-concrete.xpm
SO ./textures/chocolate.xpm

					WE 									./textures/oak.xpm
								NO ./textures/zinc.xpm


   

F 255	,255		,1
C 225			,31,				10				
111111111111111111111111
10000001 10000110000000000001
1011000N001110000000000001
1001000 00000000000000001
1111111 1011000001110000000000001
100000000011000001110111111111111
11110111111111011100000010001
1111011111111101101010010001
110000001101101110000010001
10000000000000001100000010001
1000000000000001101010010001
110000011101010111110111100111
11110111 1110111 101111010001
11111111 111111111111111111111111