	EA ./textures/east.xpm
SO ./textures/south.xpm

					WE 									./textures/west.xpm
								NO ./textures/north.xpm


   

F 255	,255		,1
C 225			,31,				10				

1111111111111111111111111
111111111011000001110000000001
100000000011000001110111111111111
1000000000100000E00000001
1011000001110000000000001
1001000000000000000000001
11110111111111011100000010001
11110111111111011101010010001
11000000110101011100000010001
10000000000000001100000010001
10000000000000001101010010001
110000011101010111110111100111
11110111 1110101 101111010001
11111111 1111111 111111111111
