	EA ./textures/m_polished-concrete.xpm
SO ./textures/m_chocolate.xpm

					WE 									./textures/m_oak.xpm
								NO ./textures/m_zinc.xpm


   

F 255	,255		,1
C 225			,31,				10				
11111111111111111
10110    000W0111
10010    00000001
10000    00000111
11110    11000111
11110    11100111
11000    00010011
10000    00000001
10000    00000001
10000    01110101
11110    11111101
11111111111111111